{
    "map1":
    [
        ["r","r","r","r","r","r","r","t","r","r","r","r","r","r","r","r","r","r","r","r","r","r","r","r","r","r","r","r","r","r"],
        ["r","r","r","r","r","r","r","r","r","r","r","r","r","r","r","r","r","r","r","r","r","r","t","r","r","r","r","r","n","r"],
        ["r","r","r","r","r","r","r","r","r","r","r","r","r","r","r","r","r","r","r","r","r","r","r","r","r","r","r","r","r","r"],
        ["r","r","r","r","r","r","w","w","w","w","r","w","w","w","w","w","w","w","r","w","w","w","w","w","r","r","r","r","r","r"],
        ["r","r","r","r","r","r","r","w","w","r","r","r","r","w","w","w","w","r","r","w","w","w","w","r","r","t","r","r","r","r"],
        ["r","r","r","w","r","r","r","w","r","r","w","w","r","r","w","w","r","r","w","w","w","w","r","r","r","r","r","r","r","r"],
        ["t","r","r","w","w","r","r","r","r","w","w","w","w","r","r","r","r","r","w","w","w","r","r","r","r","r","w","r","r","r"],
        ["r","r","r","w","w","w","r","r","r","r","s","w","w","w","w","r","r","r","r","r","r","r","r","r","r","w","w","r","t","r"],
        ["r","r","r","w","w","r","r","r","r","r","r","w","w","w","w","w","w","w","r","r","r","r","r","r","w","w","w","r","r","r"],
        ["r","r","r","w","r","r","r","w","r","r","r","w","w","w","w","w","w","w","r","r","r","r","r","w","w","w","w","r","r","r"],
        ["r","r","r","r","r","r","w","w","w","r","r","r","w","w","w","w","w","r","r","r","r","r","w","w","w","r","r","r","r","r"],
        ["r","r","r","r","r","w","w","w","r","r","r","r","r","w","w","w","r","r","r","r","r","w","w","w","w","r","r","r","r","r"],
        ["r","r","r","r","r","w","w","r","r","r","r","r","r","r","w","r","r","r","r","t","r","w","w","w","r","r","w","r","r","r"],
        ["r","r","r","w","r","w","r","r","w","w","w","w","r","r","r","r","r","r","r","w","r","w","w","w","r","w","w","r","r","r"],
        ["r","r","r","w","r","r","r","r","r","w","w","w","w","r","r","r","r","r","w","w","r","r","w","w","r","w","w","r","r","r"],
        ["r","r","r","w","w","r","w","r","r","w","w","w","r","r","r","r","r","w","w","w","w","r","r","r","r","r","w","r","r","r"],
        ["r","r","r","w","w","r","w","w","r","w","w","r","r","r","r","r","r","r","w","w","w","w","r","r","w","r","w","r","r","r"],
        ["r","r","r","w","r","r","w","w","r","w","t","r","r","r","r","w","r","r","r","r","r","r","r","w","w","r","r","r","r","r"],
        ["r","r","r","r","r","w","w","w","r","r","r","r","r","r","w","w","w","r","r","r","r","r","r","w","w","r","r","r","r","r"],
        ["r","r","r","r","r","w","w","w","r","r","r","r","r","w","w","w","w","r","r","r","r","w","w","w","r","r","r","r","r","r"],
        ["r","r","r","w","w","w","w","r","r","r","r","r","w","w","w","w","w","r","w","r","r","r","w","r","r","r","w","r","r","r"],
        ["r","r","r","w","w","w","r","r","r","r","r","r","r","r","w","w","r","r","w","r","r","r","r","r","r","w","w","r","r","r"],
        ["r","t","r","w","w","r","r","r","r","r","w","w","w","r","r","r","r","r","w","d","r","r","r","r","w","w","w","r","r","r"],
        ["r","r","r","w","r","r","r","r","r","w","w","w","w","r","r","r","w","r","r","w","w","w","r","r","r","w","w","r","r","t"],
        ["r","r","r","r","r","r","r","r","w","w","w","w","r","r","w","w","w","w","r","r","w","r","r","r","r","r","w","r","r","r"],
        ["r","r","r","r","t","r","r","w","w","w","w","r","r","w","w","w","w","w","w","r","r","r","w","w","r","r","r","r","r","r"],
        ["r","r","r","r","r","r","w","w","w","w","w","r","w","w","w","w","w","w","w","w","r","w","w","w","w","r","r","r","r","r"],
        ["r","r","r","r","r","r","r","r","r","r","r","r","r","r","r","r","r","r","r","r","r","r","r","r","r","r","r","r","r","r"],
        ["r","n","r","r","r","r","r","t","r","r","r","r","r","r","r","r","r","r","r","r","r","r","r","r","r","r","r","r","r","r"],
        ["r","r","r","r","r","r","r","r","r","r","r","r","r","r","r","r","r","r","r","r","r","r","r","t","r","r","r","r","r","r"]
    ],
    "map2":
    [
    ]
}